"filename", "language", "JSON", "JavaScript", "Markdown", "HTML", "CSS", "comment", "blank", "total"
"c:\Users\ugniu\OneDrive\Documents\Portfolio\Bakalauras\administravimosistema\client\README.md", "Markdown", 0, 0, 38, 0, 0, 0, 33, 71
"c:\Users\ugniu\OneDrive\Documents\Portfolio\Bakalauras\administravimosistema\client\package-lock.json", "JSON", 17313, 0, 0, 0, 0, 0, 1, 17314
"c:\Users\ugniu\OneDrive\Documents\Portfolio\Bakalauras\administravimosistema\client\package.json", "JSON", 58, 0, 0, 0, 0, 0, 1, 59
"c:\Users\ugniu\OneDrive\Documents\Portfolio\Bakalauras\administravimosistema\client\public\index.html", "HTML", 0, 0, 0, 23, 0, 23, 1, 47
"c:\Users\ugniu\OneDrive\Documents\Portfolio\Bakalauras\administravimosistema\client\public\manifest.json", "JSON", 25, 0, 0, 0, 0, 0, 1, 26
"c:\Users\ugniu\OneDrive\Documents\Portfolio\Bakalauras\administravimosistema\client\src\actions\auth\index.js", "JavaScript", 0, 47, 0, 0, 0, 0, 11, 58
"c:\Users\ugniu\OneDrive\Documents\Portfolio\Bakalauras\administravimosistema\client\src\actions\auth\types.js", "JavaScript", 0, 7, 0, 0, 0, 0, 1, 8
"c:\Users\ugniu\OneDrive\Documents\Portfolio\Bakalauras\administravimosistema\client\src\actions\messageGroups\index.js", "JavaScript", 0, 32, 0, 0, 0, 1, 10, 43
"c:\Users\ugniu\OneDrive\Documents\Portfolio\Bakalauras\administravimosistema\client\src\actions\messageGroups\types.js", "JavaScript", 0, 5, 0, 0, 0, 0, 0, 5
"c:\Users\ugniu\OneDrive\Documents\Portfolio\Bakalauras\administravimosistema\client\src\actions\scheduledMessages\index.js", "JavaScript", 0, 32, 0, 0, 0, 1, 10, 43
"c:\Users\ugniu\OneDrive\Documents\Portfolio\Bakalauras\administravimosistema\client\src\actions\scheduledMessages\types.js", "JavaScript", 0, 5, 0, 0, 0, 0, 0, 5
"c:\Users\ugniu\OneDrive\Documents\Portfolio\Bakalauras\administravimosistema\client\src\actions\users\index.js", "JavaScript", 0, 72, 0, 0, 0, 7, 15, 94
"c:\Users\ugniu\OneDrive\Documents\Portfolio\Bakalauras\administravimosistema\client\src\actions\users\types.js", "JavaScript", 0, 7, 0, 0, 0, 0, 1, 8
"c:\Users\ugniu\OneDrive\Documents\Portfolio\Bakalauras\administravimosistema\client\src\apis\auth.js", "JavaScript", 0, 4, 0, 0, 0, 0, 1, 5
"c:\Users\ugniu\OneDrive\Documents\Portfolio\Bakalauras\administravimosistema\client\src\apis\messageGroups.js", "JavaScript", 0, 4, 0, 0, 0, 0, 1, 5
"c:\Users\ugniu\OneDrive\Documents\Portfolio\Bakalauras\administravimosistema\client\src\apis\paypallPay.js", "JavaScript", 0, 4, 0, 0, 0, 0, 1, 5
"c:\Users\ugniu\OneDrive\Documents\Portfolio\Bakalauras\administravimosistema\client\src\apis\scheduledMessages.js", "JavaScript", 0, 4, 0, 0, 0, 0, 1, 5
"c:\Users\ugniu\OneDrive\Documents\Portfolio\Bakalauras\administravimosistema\client\src\apis\users.js", "JavaScript", 0, 4, 0, 0, 0, 0, 2, 6
"c:\Users\ugniu\OneDrive\Documents\Portfolio\Bakalauras\administravimosistema\client\src\components\App.js", "JavaScript", 0, 43, 0, 0, 0, 0, 4, 47
"c:\Users\ugniu\OneDrive\Documents\Portfolio\Bakalauras\administravimosistema\client\src\components\BasicModal.js", "JavaScript", 0, 27, 0, 0, 0, 0, 5, 32
"c:\Users\ugniu\OneDrive\Documents\Portfolio\Bakalauras\administravimosistema\client\src\components\DatePicker.js", "JavaScript", 0, 9, 0, 0, 0, 0, 3, 12
"c:\Users\ugniu\OneDrive\Documents\Portfolio\Bakalauras\administravimosistema\client\src\components\DropdownButton.js", "JavaScript", 0, 16, 0, 0, 0, 1, 3, 20
"c:\Users\ugniu\OneDrive\Documents\Portfolio\Bakalauras\administravimosistema\client\src\components\Filter.js", "JavaScript", 0, 17, 0, 0, 0, 1, 3, 21
"c:\Users\ugniu\OneDrive\Documents\Portfolio\Bakalauras\administravimosistema\client\src\components\GlobalStyles.css", "CSS", 0, 0, 0, 0, 111, 7, 23, 141
"c:\Users\ugniu\OneDrive\Documents\Portfolio\Bakalauras\administravimosistema\client\src\components\GoogleAuth.js", "JavaScript", 0, 59, 0, 0, 0, 0, 10, 69
"c:\Users\ugniu\OneDrive\Documents\Portfolio\Bakalauras\administravimosistema\client\src\components\Header.js", "JavaScript", 0, 54, 0, 0, 0, 0, 5, 59
"c:\Users\ugniu\OneDrive\Documents\Portfolio\Bakalauras\administravimosistema\client\src\components\Login.js", "JavaScript", 0, 28, 0, 0, 0, 1, 4, 33
"c:\Users\ugniu\OneDrive\Documents\Portfolio\Bakalauras\administravimosistema\client\src\components\LoginForm.js", "JavaScript", 0, 70, 0, 0, 0, 0, 8, 78
"c:\Users\ugniu\OneDrive\Documents\Portfolio\Bakalauras\administravimosistema\client\src\components\Modal.js", "JavaScript", 0, 20, 0, 0, 0, 0, 2, 22
"c:\Users\ugniu\OneDrive\Documents\Portfolio\Bakalauras\administravimosistema\client\src\components\messages\MessageGroupCreate.js", "JavaScript", 0, 42, 0, 0, 0, 0, 6, 48
"c:\Users\ugniu\OneDrive\Documents\Portfolio\Bakalauras\administravimosistema\client\src\components\messages\MessageGroupDelete.js", "JavaScript", 0, 43, 0, 0, 0, 0, 7, 50
"c:\Users\ugniu\OneDrive\Documents\Portfolio\Bakalauras\administravimosistema\client\src\components\messages\MessageGroupEdit.js", "JavaScript", 0, 51, 0, 0, 0, 0, 7, 58
"c:\Users\ugniu\OneDrive\Documents\Portfolio\Bakalauras\administravimosistema\client\src\components\messages\MessageGroupForm.js", "JavaScript", 0, 100, 0, 0, 0, 0, 14, 114
"c:\Users\ugniu\OneDrive\Documents\Portfolio\Bakalauras\administravimosistema\client\src\components\messages\MessageGroupItem.js", "JavaScript", 0, 7, 0, 0, 0, 0, 2, 9
"c:\Users\ugniu\OneDrive\Documents\Portfolio\Bakalauras\administravimosistema\client\src\components\messages\MessageGroupList.js", "JavaScript", 0, 113, 0, 0, 0, 0, 6, 119
"c:\Users\ugniu\OneDrive\Documents\Portfolio\Bakalauras\administravimosistema\client\src\components\messages\MessageGroupSendMessage.js", "JavaScript", 0, 91, 0, 0, 0, 14, 9, 114
"c:\Users\ugniu\OneDrive\Documents\Portfolio\Bakalauras\administravimosistema\client\src\components\messages\MessagesPage.js", "JavaScript", 0, 35, 0, 0, 0, 0, 3, 38
"c:\Users\ugniu\OneDrive\Documents\Portfolio\Bakalauras\administravimosistema\client\src\components\messages\ScheduledMessage.js", "JavaScript", 0, 7, 0, 0, 0, 0, 2, 9
"c:\Users\ugniu\OneDrive\Documents\Portfolio\Bakalauras\administravimosistema\client\src\components\messages\ScheduledMessageCreate.js", "JavaScript", 0, 35, 0, 0, 0, 0, 5, 40
"c:\Users\ugniu\OneDrive\Documents\Portfolio\Bakalauras\administravimosistema\client\src\components\messages\ScheduledMessageDelete.js", "JavaScript", 0, 43, 0, 0, 0, 0, 7, 50
"c:\Users\ugniu\OneDrive\Documents\Portfolio\Bakalauras\administravimosistema\client\src\components\messages\ScheduledMessageEdit.js", "JavaScript", 0, 47, 0, 0, 0, 2, 7, 56
"c:\Users\ugniu\OneDrive\Documents\Portfolio\Bakalauras\administravimosistema\client\src\components\messages\ScheduledMessageForm.js", "JavaScript", 0, 112, 0, 0, 0, 1, 14, 127
"c:\Users\ugniu\OneDrive\Documents\Portfolio\Bakalauras\administravimosistema\client\src\components\messages\ScheduledMessageList.js", "JavaScript", 0, 103, 0, 0, 0, 0, 8, 111
"c:\Users\ugniu\OneDrive\Documents\Portfolio\Bakalauras\administravimosistema\client\src\components\paypal.js", "JavaScript", 0, 5, 0, 0, 0, 0, 2, 7
"c:\Users\ugniu\OneDrive\Documents\Portfolio\Bakalauras\administravimosistema\client\src\components\users\UserCreate.js", "JavaScript", 0, 41, 0, 0, 0, 0, 4, 45
"c:\Users\ugniu\OneDrive\Documents\Portfolio\Bakalauras\administravimosistema\client\src\components\users\UserDelete.js", "JavaScript", 0, 43, 0, 0, 0, 0, 8, 51
"c:\Users\ugniu\OneDrive\Documents\Portfolio\Bakalauras\administravimosistema\client\src\components\users\UserEdit.js", "JavaScript", 0, 47, 0, 0, 0, 0, 8, 55
"c:\Users\ugniu\OneDrive\Documents\Portfolio\Bakalauras\administravimosistema\client\src\components\users\UserExtendSubscription.js", "JavaScript", 0, 50, 0, 0, 0, 0, 6, 56
"c:\Users\ugniu\OneDrive\Documents\Portfolio\Bakalauras\administravimosistema\client\src\components\users\UserForm.js", "JavaScript", 0, 124, 0, 0, 0, 3, 10, 137
"c:\Users\ugniu\OneDrive\Documents\Portfolio\Bakalauras\administravimosistema\client\src\components\users\UserList.js", "JavaScript", 0, 370, 0, 0, 0, 3, 16, 389
"c:\Users\ugniu\OneDrive\Documents\Portfolio\Bakalauras\administravimosistema\client\src\components\users\UserMessageSend.js", "JavaScript", 0, 64, 0, 0, 0, 2, 8, 74
"c:\Users\ugniu\OneDrive\Documents\Portfolio\Bakalauras\administravimosistema\client\src\components\users\UserProfileForm.js", "JavaScript", 0, 77, 0, 0, 0, 3, 10, 90
"c:\Users\ugniu\OneDrive\Documents\Portfolio\Bakalauras\administravimosistema\client\src\components\users\UserShow.js", "JavaScript", 0, 216, 0, 0, 0, 0, 14, 230
"c:\Users\ugniu\OneDrive\Documents\Portfolio\Bakalauras\administravimosistema\client\src\components\users\UserSummary.js", "JavaScript", 0, 14, 0, 0, 0, 0, 2, 16
"c:\Users\ugniu\OneDrive\Documents\Portfolio\Bakalauras\administravimosistema\client\src\history.js", "JavaScript", 0, 2, 0, 0, 0, 0, 0, 2
"c:\Users\ugniu\OneDrive\Documents\Portfolio\Bakalauras\administravimosistema\client\src\index.js", "JavaScript", 0, 18, 0, 0, 0, 0, 4, 22
"c:\Users\ugniu\OneDrive\Documents\Portfolio\Bakalauras\administravimosistema\client\src\reducers\authReducer.js", "JavaScript", 0, 40, 0, 0, 0, 8, 3, 51
"c:\Users\ugniu\OneDrive\Documents\Portfolio\Bakalauras\administravimosistema\client\src\reducers\index.js", "JavaScript", 0, 13, 0, 0, 0, 0, 1, 14
"c:\Users\ugniu\OneDrive\Documents\Portfolio\Bakalauras\administravimosistema\client\src\reducers\messageGroupReducer.js", "JavaScript", 0, 24, 0, 0, 0, 0, 1, 25
"c:\Users\ugniu\OneDrive\Documents\Portfolio\Bakalauras\administravimosistema\client\src\reducers\scheduledMessageReducer.js", "JavaScript", 0, 24, 0, 0, 0, 0, 1, 25
"c:\Users\ugniu\OneDrive\Documents\Portfolio\Bakalauras\administravimosistema\client\src\reducers\userReducer.js", "JavaScript", 0, 24, 0, 0, 0, 0, 1, 25
"c:\Users\ugniu\OneDrive\Documents\Portfolio\Bakalauras\administravimosistema\client\src\services\auth-header.js", "JavaScript", 0, 8, 0, 0, 0, 0, 1, 9
"c:\Users\ugniu\OneDrive\Documents\Portfolio\Bakalauras\administravimosistema\client\src\services\auth.service.js", "JavaScript", 0, 30, 0, 0, 0, 0, 7, 37
"c:\Users\ugniu\OneDrive\Documents\Portfolio\Bakalauras\administravimosistema\client\src\services\user.service.js", "JavaScript", 0, 15, 0, 0, 0, 3, 6, 24
"Total", "-", 17396, 2648, 38, 23, 111, 81, 371, 20668