"filename", "language", "JavaScript", "CSS", "JSON", "HTML", "Markdown", "comment", "blank", "total"
"c:\Users\ugniu\OneDrive\Documents\Portfolio\Bakalauras\administravimosistema\client\README.md", "Markdown", 0, 0, 0, 0, 38, 0, 33, 71
"c:\Users\ugniu\OneDrive\Documents\Portfolio\Bakalauras\administravimosistema\client\Utils\index.js", "JavaScript", 16, 0, 0, 0, 0, 0, 4, 20
"c:\Users\ugniu\OneDrive\Documents\Portfolio\Bakalauras\administravimosistema\client\package-lock.json", "JSON", 0, 0, 19699, 0, 0, 0, 1, 19700
"c:\Users\ugniu\OneDrive\Documents\Portfolio\Bakalauras\administravimosistema\client\package.json", "JSON", 0, 0, 71, 0, 0, 0, 1, 72
"c:\Users\ugniu\OneDrive\Documents\Portfolio\Bakalauras\administravimosistema\client\public\index.html", "HTML", 0, 0, 0, 23, 0, 23, 1, 47
"c:\Users\ugniu\OneDrive\Documents\Portfolio\Bakalauras\administravimosistema\client\public\manifest.json", "JSON", 0, 0, 25, 0, 0, 0, 1, 26
"c:\Users\ugniu\OneDrive\Documents\Portfolio\Bakalauras\administravimosistema\client\src\actions\auth\index.js", "JavaScript", 46, 0, 0, 0, 0, 0, 11, 57
"c:\Users\ugniu\OneDrive\Documents\Portfolio\Bakalauras\administravimosistema\client\src\actions\auth\types.js", "JavaScript", 7, 0, 0, 0, 0, 0, 1, 8
"c:\Users\ugniu\OneDrive\Documents\Portfolio\Bakalauras\administravimosistema\client\src\actions\messageGroups\index.js", "JavaScript", 32, 0, 0, 0, 0, 0, 10, 42
"c:\Users\ugniu\OneDrive\Documents\Portfolio\Bakalauras\administravimosistema\client\src\actions\messageGroups\types.js", "JavaScript", 5, 0, 0, 0, 0, 0, 0, 5
"c:\Users\ugniu\OneDrive\Documents\Portfolio\Bakalauras\administravimosistema\client\src\actions\scheduledMessages\index.js", "JavaScript", 32, 0, 0, 0, 0, 0, 10, 42
"c:\Users\ugniu\OneDrive\Documents\Portfolio\Bakalauras\administravimosistema\client\src\actions\scheduledMessages\types.js", "JavaScript", 5, 0, 0, 0, 0, 0, 0, 5
"c:\Users\ugniu\OneDrive\Documents\Portfolio\Bakalauras\administravimosistema\client\src\actions\users\index.js", "JavaScript", 72, 0, 0, 0, 0, 7, 15, 94
"c:\Users\ugniu\OneDrive\Documents\Portfolio\Bakalauras\administravimosistema\client\src\actions\users\types.js", "JavaScript", 7, 0, 0, 0, 0, 0, 1, 8
"c:\Users\ugniu\OneDrive\Documents\Portfolio\Bakalauras\administravimosistema\client\src\apis\auth.js", "JavaScript", 4, 0, 0, 0, 0, 0, 1, 5
"c:\Users\ugniu\OneDrive\Documents\Portfolio\Bakalauras\administravimosistema\client\src\apis\messageGroups.js", "JavaScript", 4, 0, 0, 0, 0, 0, 1, 5
"c:\Users\ugniu\OneDrive\Documents\Portfolio\Bakalauras\administravimosistema\client\src\apis\paypallPay.js", "JavaScript", 4, 0, 0, 0, 0, 0, 1, 5
"c:\Users\ugniu\OneDrive\Documents\Portfolio\Bakalauras\administravimosistema\client\src\apis\scheduledMessages.js", "JavaScript", 4, 0, 0, 0, 0, 0, 1, 5
"c:\Users\ugniu\OneDrive\Documents\Portfolio\Bakalauras\administravimosistema\client\src\apis\users.js", "JavaScript", 4, 0, 0, 0, 0, 0, 2, 6
"c:\Users\ugniu\OneDrive\Documents\Portfolio\Bakalauras\administravimosistema\client\src\components\App.js", "JavaScript", 37, 0, 0, 0, 0, 0, 3, 40
"c:\Users\ugniu\OneDrive\Documents\Portfolio\Bakalauras\administravimosistema\client\src\components\BasicModal.js", "JavaScript", 27, 0, 0, 0, 0, 0, 5, 32
"c:\Users\ugniu\OneDrive\Documents\Portfolio\Bakalauras\administravimosistema\client\src\components\DatePicker.js", "JavaScript", 9, 0, 0, 0, 0, 0, 3, 12
"c:\Users\ugniu\OneDrive\Documents\Portfolio\Bakalauras\administravimosistema\client\src\components\Filter.js", "JavaScript", 17, 0, 0, 0, 0, 0, 3, 20
"c:\Users\ugniu\OneDrive\Documents\Portfolio\Bakalauras\administravimosistema\client\src\components\GlobalStyles.css", "CSS", 0, 127, 0, 0, 0, 7, 26, 160
"c:\Users\ugniu\OneDrive\Documents\Portfolio\Bakalauras\administravimosistema\client\src\components\Header.js", "JavaScript", 69, 0, 0, 0, 0, 0, 5, 74
"c:\Users\ugniu\OneDrive\Documents\Portfolio\Bakalauras\administravimosistema\client\src\components\Login.js", "JavaScript", 28, 0, 0, 0, 0, 1, 4, 33
"c:\Users\ugniu\OneDrive\Documents\Portfolio\Bakalauras\administravimosistema\client\src\components\LoginForm.js", "JavaScript", 68, 0, 0, 0, 0, 0, 8, 76
"c:\Users\ugniu\OneDrive\Documents\Portfolio\Bakalauras\administravimosistema\client\src\components\Modal.js", "JavaScript", 20, 0, 0, 0, 0, 0, 2, 22
"c:\Users\ugniu\OneDrive\Documents\Portfolio\Bakalauras\administravimosistema\client\src\components\__test__\Filter.test.js", "JavaScript", 10, 0, 0, 0, 0, 0, 1, 11
"c:\Users\ugniu\OneDrive\Documents\Portfolio\Bakalauras\administravimosistema\client\src\components\__test__\Header.test.js", "JavaScript", 24, 0, 0, 0, 0, 16, 6, 46
"c:\Users\ugniu\OneDrive\Documents\Portfolio\Bakalauras\administravimosistema\client\src\components\__test__\Login.test.js", "JavaScript", 17, 0, 0, 0, 0, 0, 1, 18
"c:\Users\ugniu\OneDrive\Documents\Portfolio\Bakalauras\administravimosistema\client\src\components\messages\MessageGroupCreate.js", "JavaScript", 42, 0, 0, 0, 0, 0, 6, 48
"c:\Users\ugniu\OneDrive\Documents\Portfolio\Bakalauras\administravimosistema\client\src\components\messages\MessageGroupDelete.js", "JavaScript", 43, 0, 0, 0, 0, 0, 7, 50
"c:\Users\ugniu\OneDrive\Documents\Portfolio\Bakalauras\administravimosistema\client\src\components\messages\MessageGroupEdit.js", "JavaScript", 50, 0, 0, 0, 0, 0, 7, 57
"c:\Users\ugniu\OneDrive\Documents\Portfolio\Bakalauras\administravimosistema\client\src\components\messages\MessageGroupForm.js", "JavaScript", 99, 0, 0, 0, 0, 0, 14, 113
"c:\Users\ugniu\OneDrive\Documents\Portfolio\Bakalauras\administravimosistema\client\src\components\messages\MessageGroupList.js", "JavaScript", 112, 0, 0, 0, 0, 0, 6, 118
"c:\Users\ugniu\OneDrive\Documents\Portfolio\Bakalauras\administravimosistema\client\src\components\messages\MessageGroupSendMessage.js", "JavaScript", 87, 0, 0, 0, 0, 0, 9, 96
"c:\Users\ugniu\OneDrive\Documents\Portfolio\Bakalauras\administravimosistema\client\src\components\messages\MessagesPage.js", "JavaScript", 37, 0, 0, 0, 0, 0, 3, 40
"c:\Users\ugniu\OneDrive\Documents\Portfolio\Bakalauras\administravimosistema\client\src\components\messages\ScheduledMessageCreate.js", "JavaScript", 35, 0, 0, 0, 0, 0, 5, 40
"c:\Users\ugniu\OneDrive\Documents\Portfolio\Bakalauras\administravimosistema\client\src\components\messages\ScheduledMessageDelete.js", "JavaScript", 43, 0, 0, 0, 0, 0, 7, 50
"c:\Users\ugniu\OneDrive\Documents\Portfolio\Bakalauras\administravimosistema\client\src\components\messages\ScheduledMessageEdit.js", "JavaScript", 46, 0, 0, 0, 0, 0, 7, 53
"c:\Users\ugniu\OneDrive\Documents\Portfolio\Bakalauras\administravimosistema\client\src\components\messages\ScheduledMessageForm.js", "JavaScript", 111, 0, 0, 0, 0, 0, 14, 125
"c:\Users\ugniu\OneDrive\Documents\Portfolio\Bakalauras\administravimosistema\client\src\components\messages\ScheduledMessageList.js", "JavaScript", 102, 0, 0, 0, 0, 0, 8, 110
"c:\Users\ugniu\OneDrive\Documents\Portfolio\Bakalauras\administravimosistema\client\src\components\paypal.js", "JavaScript", 5, 0, 0, 0, 0, 0, 2, 7
"c:\Users\ugniu\OneDrive\Documents\Portfolio\Bakalauras\administravimosistema\client\src\components\users\UserCreate.js", "JavaScript", 46, 0, 0, 0, 0, 0, 4, 50
"c:\Users\ugniu\OneDrive\Documents\Portfolio\Bakalauras\administravimosistema\client\src\components\users\UserDelete.js", "JavaScript", 50, 0, 0, 0, 0, 0, 9, 59
"c:\Users\ugniu\OneDrive\Documents\Portfolio\Bakalauras\administravimosistema\client\src\components\users\UserEdit.js", "JavaScript", 51, 0, 0, 0, 0, 0, 8, 59
"c:\Users\ugniu\OneDrive\Documents\Portfolio\Bakalauras\administravimosistema\client\src\components\users\UserExtendSubscription.js", "JavaScript", 66, 0, 0, 0, 0, 0, 7, 73
"c:\Users\ugniu\OneDrive\Documents\Portfolio\Bakalauras\administravimosistema\client\src\components\users\UserForm.js", "JavaScript", 123, 0, 0, 0, 0, 3, 10, 136
"c:\Users\ugniu\OneDrive\Documents\Portfolio\Bakalauras\administravimosistema\client\src\components\users\UserList.js", "JavaScript", 366, 0, 0, 0, 0, 1, 16, 383
"c:\Users\ugniu\OneDrive\Documents\Portfolio\Bakalauras\administravimosistema\client\src\components\users\UserMessageSend.js", "JavaScript", 64, 0, 0, 0, 0, 0, 8, 72
"c:\Users\ugniu\OneDrive\Documents\Portfolio\Bakalauras\administravimosistema\client\src\components\users\UserProfileForm.js", "JavaScript", 92, 0, 0, 0, 0, 0, 10, 102
"c:\Users\ugniu\OneDrive\Documents\Portfolio\Bakalauras\administravimosistema\client\src\components\users\UserShow.js", "JavaScript", 275, 0, 0, 0, 0, 0, 14, 289
"c:\Users\ugniu\OneDrive\Documents\Portfolio\Bakalauras\administravimosistema\client\src\components\users\UserSummary.js", "JavaScript", 12, 0, 0, 0, 0, 0, 2, 14
"c:\Users\ugniu\OneDrive\Documents\Portfolio\Bakalauras\administravimosistema\client\src\components\users\__test__\UserCreate.test.js", "JavaScript", 23, 0, 0, 0, 0, 16, 4, 43
"c:\Users\ugniu\OneDrive\Documents\Portfolio\Bakalauras\administravimosistema\client\src\components\users\__test__\UserDelete.test.js", "JavaScript", 17, 0, 0, 0, 0, 0, 2, 19
"c:\Users\ugniu\OneDrive\Documents\Portfolio\Bakalauras\administravimosistema\client\src\components\users\__test__\UserEdit.test.js", "JavaScript", 23, 0, 0, 0, 0, 6, 3, 32
"c:\Users\ugniu\OneDrive\Documents\Portfolio\Bakalauras\administravimosistema\client\src\components\users\__test__\UserList.test.js", "JavaScript", 17, 0, 0, 0, 0, 0, 1, 18
"c:\Users\ugniu\OneDrive\Documents\Portfolio\Bakalauras\administravimosistema\client\src\components\users\__test__\UserShow.test.js", "JavaScript", 17, 0, 0, 0, 0, 0, 2, 19
"c:\Users\ugniu\OneDrive\Documents\Portfolio\Bakalauras\administravimosistema\client\src\components\users\__test__\UserSummary.test.js", "JavaScript", 7, 0, 0, 0, 0, 2, 4, 13
"c:\Users\ugniu\OneDrive\Documents\Portfolio\Bakalauras\administravimosistema\client\src\components\users\__test__\test-utils.js", "JavaScript", 22, 0, 0, 0, 0, 4, 2, 28
"c:\Users\ugniu\OneDrive\Documents\Portfolio\Bakalauras\administravimosistema\client\src\history.js", "JavaScript", 2, 0, 0, 0, 0, 0, 0, 2
"c:\Users\ugniu\OneDrive\Documents\Portfolio\Bakalauras\administravimosistema\client\src\index.js", "JavaScript", 11, 0, 0, 0, 0, 0, 3, 14
"c:\Users\ugniu\OneDrive\Documents\Portfolio\Bakalauras\administravimosistema\client\src\reducers\authReducer.js", "JavaScript", 40, 0, 0, 0, 0, 0, 3, 43
"c:\Users\ugniu\OneDrive\Documents\Portfolio\Bakalauras\administravimosistema\client\src\reducers\index.js", "JavaScript", 13, 0, 0, 0, 0, 0, 1, 14
"c:\Users\ugniu\OneDrive\Documents\Portfolio\Bakalauras\administravimosistema\client\src\reducers\messageGroupReducer.js", "JavaScript", 24, 0, 0, 0, 0, 0, 1, 25
"c:\Users\ugniu\OneDrive\Documents\Portfolio\Bakalauras\administravimosistema\client\src\reducers\scheduledMessageReducer.js", "JavaScript", 24, 0, 0, 0, 0, 0, 1, 25
"c:\Users\ugniu\OneDrive\Documents\Portfolio\Bakalauras\administravimosistema\client\src\reducers\userReducer.js", "JavaScript", 24, 0, 0, 0, 0, 0, 1, 25
"c:\Users\ugniu\OneDrive\Documents\Portfolio\Bakalauras\administravimosistema\client\src\services\auth-header.js", "JavaScript", 8, 0, 0, 0, 0, 0, 1, 9
"c:\Users\ugniu\OneDrive\Documents\Portfolio\Bakalauras\administravimosistema\client\src\services\auth.service.js", "JavaScript", 30, 0, 0, 0, 0, 0, 7, 37
"c:\Users\ugniu\OneDrive\Documents\Portfolio\Bakalauras\administravimosistema\client\src\services\user.service.js", "JavaScript", 15, 0, 0, 0, 0, 3, 6, 24
"c:\Users\ugniu\OneDrive\Documents\Portfolio\Bakalauras\administravimosistema\client\src\setupTests.js", "JavaScript", 3, 0, 0, 0, 0, 0, 1, 4
"c:\Users\ugniu\OneDrive\Documents\Portfolio\Bakalauras\administravimosistema\client\src\store.js", "JavaScript", 8, 0, 0, 0, 0, 0, 1, 9
"Total", "-", 2853, 127, 19795, 23, 38, 89, 389, 23314