"filename", "language", "JavaScript", "JSON", "Markdown", "HTML", "CSS", "comment", "blank", "total"
"c:\Users\ugniu\OneDrive\Documents\Portfolio\Bakalauras\administravimosistema\client\README.md", "Markdown", 0, 0, 38, 0, 0, 0, 33, 71
"c:\Users\ugniu\OneDrive\Documents\Portfolio\Bakalauras\administravimosistema\client\package-lock.json", "JSON", 0, 17262, 0, 0, 0, 0, 1, 17263
"c:\Users\ugniu\OneDrive\Documents\Portfolio\Bakalauras\administravimosistema\client\package.json", "JSON", 0, 57, 0, 0, 0, 0, 1, 58
"c:\Users\ugniu\OneDrive\Documents\Portfolio\Bakalauras\administravimosistema\client\public\index.html", "HTML", 0, 0, 0, 23, 0, 23, 1, 47
"c:\Users\ugniu\OneDrive\Documents\Portfolio\Bakalauras\administravimosistema\client\public\manifest.json", "JSON", 0, 25, 0, 0, 0, 0, 1, 26
"c:\Users\ugniu\OneDrive\Documents\Portfolio\Bakalauras\administravimosistema\client\src\actions\messageGroups\index.js", "JavaScript", 32, 0, 0, 0, 0, 1, 10, 43
"c:\Users\ugniu\OneDrive\Documents\Portfolio\Bakalauras\administravimosistema\client\src\actions\messageGroups\types.js", "JavaScript", 5, 0, 0, 0, 0, 0, 0, 5
"c:\Users\ugniu\OneDrive\Documents\Portfolio\Bakalauras\administravimosistema\client\src\actions\scheduledMessages\index.js", "JavaScript", 32, 0, 0, 0, 0, 1, 10, 43
"c:\Users\ugniu\OneDrive\Documents\Portfolio\Bakalauras\administravimosistema\client\src\actions\scheduledMessages\types.js", "JavaScript", 5, 0, 0, 0, 0, 0, 0, 5
"c:\Users\ugniu\OneDrive\Documents\Portfolio\Bakalauras\administravimosistema\client\src\actions\users\index.js", "JavaScript", 46, 0, 0, 0, 0, 2, 12, 60
"c:\Users\ugniu\OneDrive\Documents\Portfolio\Bakalauras\administravimosistema\client\src\actions\users\types.js", "JavaScript", 7, 0, 0, 0, 0, 0, 0, 7
"c:\Users\ugniu\OneDrive\Documents\Portfolio\Bakalauras\administravimosistema\client\src\apis\messageGroups.js", "JavaScript", 4, 0, 0, 0, 0, 0, 1, 5
"c:\Users\ugniu\OneDrive\Documents\Portfolio\Bakalauras\administravimosistema\client\src\apis\paypallPay.js", "JavaScript", 4, 0, 0, 0, 0, 0, 1, 5
"c:\Users\ugniu\OneDrive\Documents\Portfolio\Bakalauras\administravimosistema\client\src\apis\scheduledMessages.js", "JavaScript", 4, 0, 0, 0, 0, 0, 1, 5
"c:\Users\ugniu\OneDrive\Documents\Portfolio\Bakalauras\administravimosistema\client\src\apis\users.js", "JavaScript", 4, 0, 0, 0, 0, 0, 1, 5
"c:\Users\ugniu\OneDrive\Documents\Portfolio\Bakalauras\administravimosistema\client\src\components\App.js", "JavaScript", 41, 0, 0, 0, 0, 0, 4, 45
"c:\Users\ugniu\OneDrive\Documents\Portfolio\Bakalauras\administravimosistema\client\src\components\BasicModal.js", "JavaScript", 27, 0, 0, 0, 0, 0, 5, 32
"c:\Users\ugniu\OneDrive\Documents\Portfolio\Bakalauras\administravimosistema\client\src\components\DatePicker.js", "JavaScript", 9, 0, 0, 0, 0, 0, 3, 12
"c:\Users\ugniu\OneDrive\Documents\Portfolio\Bakalauras\administravimosistema\client\src\components\DropdownButton.js", "JavaScript", 16, 0, 0, 0, 0, 1, 3, 20
"c:\Users\ugniu\OneDrive\Documents\Portfolio\Bakalauras\administravimosistema\client\src\components\Filter.js", "JavaScript", 17, 0, 0, 0, 0, 1, 3, 21
"c:\Users\ugniu\OneDrive\Documents\Portfolio\Bakalauras\administravimosistema\client\src\components\GlobalStyles.css", "CSS", 0, 0, 0, 0, 100, 7, 21, 128
"c:\Users\ugniu\OneDrive\Documents\Portfolio\Bakalauras\administravimosistema\client\src\components\GoogleAuth.js", "JavaScript", 59, 0, 0, 0, 0, 0, 10, 69
"c:\Users\ugniu\OneDrive\Documents\Portfolio\Bakalauras\administravimosistema\client\src\components\Header.js", "JavaScript", 26, 0, 0, 0, 0, 23, 4, 53
"c:\Users\ugniu\OneDrive\Documents\Portfolio\Bakalauras\administravimosistema\client\src\components\Login.js", "JavaScript", 27, 0, 0, 0, 0, 0, 5, 32
"c:\Users\ugniu\OneDrive\Documents\Portfolio\Bakalauras\administravimosistema\client\src\components\LoginForm.js", "JavaScript", 73, 0, 0, 0, 0, 28, 12, 113
"c:\Users\ugniu\OneDrive\Documents\Portfolio\Bakalauras\administravimosistema\client\src\components\Modal.js", "JavaScript", 20, 0, 0, 0, 0, 0, 2, 22
"c:\Users\ugniu\OneDrive\Documents\Portfolio\Bakalauras\administravimosistema\client\src\components\messages\MessageGroupCreate.js", "JavaScript", 41, 0, 0, 0, 0, 0, 6, 47
"c:\Users\ugniu\OneDrive\Documents\Portfolio\Bakalauras\administravimosistema\client\src\components\messages\MessageGroupDelete.js", "JavaScript", 43, 0, 0, 0, 0, 0, 7, 50
"c:\Users\ugniu\OneDrive\Documents\Portfolio\Bakalauras\administravimosistema\client\src\components\messages\MessageGroupEdit.js", "JavaScript", 46, 0, 0, 0, 0, 1, 7, 54
"c:\Users\ugniu\OneDrive\Documents\Portfolio\Bakalauras\administravimosistema\client\src\components\messages\MessageGroupForm.js", "JavaScript", 90, 0, 0, 0, 0, 0, 13, 103
"c:\Users\ugniu\OneDrive\Documents\Portfolio\Bakalauras\administravimosistema\client\src\components\messages\MessageGroupItem.js", "JavaScript", 7, 0, 0, 0, 0, 0, 2, 9
"c:\Users\ugniu\OneDrive\Documents\Portfolio\Bakalauras\administravimosistema\client\src\components\messages\MessageGroupList.js", "JavaScript", 107, 0, 0, 0, 0, 0, 7, 114
"c:\Users\ugniu\OneDrive\Documents\Portfolio\Bakalauras\administravimosistema\client\src\components\messages\MessagesPage.js", "JavaScript", 29, 0, 0, 0, 0, 0, 3, 32
"c:\Users\ugniu\OneDrive\Documents\Portfolio\Bakalauras\administravimosistema\client\src\components\messages\ScheduledMessage.js", "JavaScript", 7, 0, 0, 0, 0, 0, 2, 9
"c:\Users\ugniu\OneDrive\Documents\Portfolio\Bakalauras\administravimosistema\client\src\components\messages\ScheduledMessageCreate.js", "JavaScript", 34, 0, 0, 0, 0, 0, 5, 39
"c:\Users\ugniu\OneDrive\Documents\Portfolio\Bakalauras\administravimosistema\client\src\components\messages\ScheduledMessageEdit.js", "JavaScript", 0, 0, 0, 0, 0, 0, 1, 1
"c:\Users\ugniu\OneDrive\Documents\Portfolio\Bakalauras\administravimosistema\client\src\components\messages\ScheduledMessageForm.js", "JavaScript", 103, 0, 0, 0, 0, 8, 15, 126
"c:\Users\ugniu\OneDrive\Documents\Portfolio\Bakalauras\administravimosistema\client\src\components\messages\ScheduledMessageList.js", "JavaScript", 107, 0, 0, 0, 0, 3, 9, 119
"c:\Users\ugniu\OneDrive\Documents\Portfolio\Bakalauras\administravimosistema\client\src\components\paypal.js", "JavaScript", 5, 0, 0, 0, 0, 0, 2, 7
"c:\Users\ugniu\OneDrive\Documents\Portfolio\Bakalauras\administravimosistema\client\src\components\users\UserCreate.js", "JavaScript", 38, 0, 0, 0, 0, 1, 5, 44
"c:\Users\ugniu\OneDrive\Documents\Portfolio\Bakalauras\administravimosistema\client\src\components\users\UserDelete.js", "JavaScript", 43, 0, 0, 0, 0, 0, 8, 51
"c:\Users\ugniu\OneDrive\Documents\Portfolio\Bakalauras\administravimosistema\client\src\components\users\UserEdit.js", "JavaScript", 48, 0, 0, 0, 0, 11, 9, 68
"c:\Users\ugniu\OneDrive\Documents\Portfolio\Bakalauras\administravimosistema\client\src\components\users\UserExtendSubscription.js", "JavaScript", 50, 0, 0, 0, 0, 0, 6, 56
"c:\Users\ugniu\OneDrive\Documents\Portfolio\Bakalauras\administravimosistema\client\src\components\users\UserForm.js", "JavaScript", 110, 0, 0, 0, 0, 3, 10, 123
"c:\Users\ugniu\OneDrive\Documents\Portfolio\Bakalauras\administravimosistema\client\src\components\users\UserList.js", "JavaScript", 353, 0, 0, 0, 0, 2, 16, 371
"c:\Users\ugniu\OneDrive\Documents\Portfolio\Bakalauras\administravimosistema\client\src\components\users\UserMessageSend.js", "JavaScript", 56, 0, 0, 0, 0, 3, 7, 66
"c:\Users\ugniu\OneDrive\Documents\Portfolio\Bakalauras\administravimosistema\client\src\components\users\UserProfileForm.js", "JavaScript", 72, 0, 0, 0, 0, 3, 10, 85
"c:\Users\ugniu\OneDrive\Documents\Portfolio\Bakalauras\administravimosistema\client\src\components\users\UserShow.js", "JavaScript", 175, 0, 0, 0, 0, 0, 14, 189
"c:\Users\ugniu\OneDrive\Documents\Portfolio\Bakalauras\administravimosistema\client\src\components\users\UserSummary.js", "JavaScript", 14, 0, 0, 0, 0, 0, 2, 16
"c:\Users\ugniu\OneDrive\Documents\Portfolio\Bakalauras\administravimosistema\client\src\history.js", "JavaScript", 2, 0, 0, 0, 0, 0, 0, 2
"c:\Users\ugniu\OneDrive\Documents\Portfolio\Bakalauras\administravimosistema\client\src\index.js", "JavaScript", 18, 0, 0, 0, 0, 0, 4, 22
"c:\Users\ugniu\OneDrive\Documents\Portfolio\Bakalauras\administravimosistema\client\src\reducers\authReducer.js", "JavaScript", 15, 0, 0, 0, 0, 0, 2, 17
"c:\Users\ugniu\OneDrive\Documents\Portfolio\Bakalauras\administravimosistema\client\src\reducers\index.js", "JavaScript", 13, 0, 0, 0, 0, 0, 1, 14
"c:\Users\ugniu\OneDrive\Documents\Portfolio\Bakalauras\administravimosistema\client\src\reducers\messageGroupReducer.js", "JavaScript", 24, 0, 0, 0, 0, 0, 1, 25
"c:\Users\ugniu\OneDrive\Documents\Portfolio\Bakalauras\administravimosistema\client\src\reducers\scheduledMessageReducer.js", "JavaScript", 24, 0, 0, 0, 0, 0, 1, 25
"c:\Users\ugniu\OneDrive\Documents\Portfolio\Bakalauras\administravimosistema\client\src\reducers\userReducer.js", "JavaScript", 24, 0, 0, 0, 0, 0, 1, 25
"Total", "-", 2156, 17344, 38, 23, 100, 122, 321, 20104